1111111111111111111111111
10C00000000000C000000C0E1
1000000000000000011000001
1E0000000000000000C000001
10000000000110000000000E1
100C00000P1111000000C0001
1111111111111111111111111