11111111111111111111111111111111
10C00000000000C000000C0000000001
100000000P0000000110000000000001
10E000000000000000C0000000000001
11111111111111111111111111111111